%%%%%%%%%%%%%%%%%%%%%%%%%%%%%%%%%%%%%
% P                                 %
% ...       ...  %       .        . %
% .  .     .   . %      . .       . %
% .   .     .    %     .   .      . % 
% .   .      .   %  . . . . . .   . %
% .  .    .   .  %   .       .    . %
% . .      ...   %  .         .   . %                                         
%                      G        G   %                                                                                                     
%%%%%%%%%%%%%%%%%%%%%%%%%%%%%%%%%%%%%