%%%%%%%%%%%%%%%%%%%%%%%%%%%%%%
%.......% % %..............%.%
%.......% % %%%%%% %%%%%%% % %
%.......%.....G  %.....% %   %
%%%%% %%%%% %%% %% %%%%% % %%%
%   % % % %   %    %.....%   %
% %%% % % % %%%%%%%% %%% %%% %
%.......%.....%%.....% % %   %
%%% % %%%%%%% %%%% %%% % % % %
% %...........%%.....%    o% %
% % %%%%% % %%%% % %%% %%% % %
%   %     %......% %   % %%% %
%.  %P%%%%%......% %%% %    .%
%%%%%%%%%%%%%%%%%%%%%%%%%%%%%%